1 1 1 1 1 1 1 1 1 1 1 1 1 1 1 1 1 1 1 1
1 7 4 0 0 2 4 0 4 1 1 0 0 0 0 2 5 0 7 1
1 0 0 0 0 2 0 0 0 3 3 0 2 2 0 2 0 0 0 1
1 0 2 2 0 2 0 0 0 1 1 2 2 0 0 2 0 0 5 1
1 0 4 2 0 2 2 2 0 1 1 0 0 0 2 2 0 0 0 1
1 2 0 2 0 2 0 0 0 1 1 0 5 0 2 0 0 5 0 1
1 0 0 2 0 2 0 2 2 1 1 0 0 0 2 5 2 0 0 1
1 0 2 2 4 2 0 0 0 1 1 2 0 2 2 2 2 0 0 1
1 0 2 2 0 0 0 0 7 1 1 0 0 0 0 0 0 0 8 1
1 1 1 1 1 1 1 1 1 1 1 1 1 1 1 1 3 1 1 1
1 1 1 1 1 1 1 1 1 1 1 1 1 1 1 1 3 1 1 1
1 8 8 8 8 8 8 8 8 1 1 8 0 0 0 0 0 0 8 1
1 8 0 0 0 0 0 0 8 1 1 0 0 0 0 0 0 0 0 1
1 8 0 0 0 2 0 0 8 1 1 0 0 0 0 0 0 0 0 1
1 8 0 0 0 0 0 0 8 1 1 2 0 2 0 2 0 2 0 1
1 6 0 0 0 0 0 0 0 3 3 0 0 0 0 0 0 0 0 1
1 8 0 0 0 0 0 0 8 1 1 0 0 0 0 0 0 0 0 1
1 8 0 0 0 2 0 0 8 1 1 0 2 0 2 0 2 0 2 1
1 8 8 8 8 8 8 8 8 1 1 8 7 0 0 0 0 7 8 1
1 1 1 1 1 1 1 1 1 1 1 1 1 1 1 1 1 1 1 1