1 1 1 1 1 1 1 1 1 1 1 1 1 1 1 1 1 1 1 1
1 3 4 0 3 1 4 0 4 1 1 0 0 0 0 0 0 0 0 1
1 0 0 0 0 1 0 0 0 5 5 0 0 0 0 0 0 0 0 1
1 0 1 1 0 1 0 0 0 1 1 0 0 0 0 0 0 0 0 1
1 0 4 1 0 0 1 1 0 1 1 0 0 0 0 0 0 0 0 1
1 1 0 1 0 1 0 0 0 1 1 0 0 0 0 0 0 0 0 1
1 0 0 1 0 1 0 1 1 1 1 0 0 0 0 0 0 0 0 1
1 0 1 1 4 1 0 0 0 1 1 0 0 0 0 0 0 0 0 1
1 3 1 1 0 0 0 0 0 1 1 0 0 0 0 0 0 0 0 1
1 1 1 1 1 1 1 1 1 1 1 1 1 1 1 1 5 1 1 1